# H 0 0 R 
# O 0 1 LR
# H 0 2 L

# H 3 2 L
# H 3 7 R 
# O 8 6 LR

XXXXXXXXXXX
X   XXXXXXX
X   XXXXXXX
X  X     XX
X X      XX
X X  X XX X
X    X X  X
XXX X  X  X
XX        X
XXXXXXXXXXX