# H 1 0 D
# H 0 1 R
# C 1 1 UDLR
# O 2 1 LR
# H 3 1 L
# H 1 2 U

# H 2 3 D
# H 2 8 R
# O 6 8 LR
# C 9 7 UDLR
# H 5 10 U
# H 8 19 L

XXXXXXXXXXXXX
X  XXXXXXXXXX
X  XXXXXXXXXX
X  XXXXXXXXXX
X  XXXXXXXXXX
X   X   X XXX
X X     X   X
X       X   X
X  XXX  X X X
X           X
X      X  X X
XXXXXX    X X
XXXXXXXXXXXXX
