# H 1 0 D
# H 2 1 L
# C 1 1 UDLR
# H 0 1 R
# H 1 2 U

# H 9 4 D
# H 8 8 L
# C 5 4 UDLR
# H 2 5 R
# H 3 9 U

XXXXXXXXXXXXXX
X   XXXXXXXXXX
X   XXXXXXXXXX
X X X X      X
X X X X   X  X
X  X  XXXXX  X
X       X    X
X       X    X
X XXXXX      X
X   X  XXXXXXX
XXXXXXXXXXXXXX
