# H 0 0 R 
# O 1 0 LR
# H 2 0 L

# H 3 7 R 
# O 8 6 LR
# H 3 2 L

XXXXXXXXXXX
X   XXXXXXX
X   XXXXXXX
X  X     XX
X X      XX
X X  X XX X
X    X X  X
XXX X  X  X
XX        X
XXXXXXXXXXX
